rows 120
cols 138
players 2
m ...................%....%%%....%%.........%%...........%%...........%%.........%%....%%%....%......................%%................%%...
m ...................%%...%%....%%%.........%%..........%%%%..........%%.........%%%....%%...%%......................%%................%%...
m ..................%%.....%%...%%...........%%..........%%..........%%...........%%...%%.....%%......................%................%....
m ..%.%%%%%%.%..%....%%%..%%%....%%.....%...%%%...%..%%.%%%%.%%..%...%%%...%.....%%....%%%..%%%....%..%.%%%%%%.%.....%%....%%%..%%%....%%...
m .%%%%%%%%%%%%%....%%%%%%%%%....%%....%%%%%%%.....%%%%%%%%%%%%%%.....%%%%%%%....%%....%%%%%%%%%....%%%%%%%%%%%%%....%%.....%%%%%%.....%%...
m .%%%.%%%%.%%%%........%%%%%...%%%...%...%.%%....%%%..%....%..%%%....%%.%...%...%%%...%%%%%........%%%%.%%%%.%%%....%.%...%.%%%%.%...%.%...
m .%%.........%%%...............%%%.........%%........................%%.........%%%...............%%%.........%%...........................
m %%...........%................%%%.........%%........................%%.........%%%................%...........%%..........................
m %%%.........%%%................%...........%........................%...........%................%%%.........%%%..........................
m %%......%....%%.%%.%%%%.%%.%..%%%..%......%%%.........%..%.........%%%......%..%%%..%.%%.%%%%.%%.%%....%......%%.%%.%%%..%......%..%%%.%%.
m %%%...%%%....%%%%%%%%%%%%%%%%%%%%%%%%%%...%%%%%%%%.....%%.....%%%%%%%%...%%%%%%%%%%%%%%%%%%%%%%%%%%....%%%...%%%%%%%%%%%%%%....%%%%%%%%%%%
m %%%...%%%...%%%.%.%.%%......%.%%....%%....%%%%%.%.%....%%....%.%.%%%%%....%%....%%.%......%%.%.%.%%%...%%%...%%%%%%%%.%%%........%%%.%%%%%
m .....1.%%...%%%......................%%...%%..........%%%%..........%%...%%......................%%%...%%.0...............................
m .......%%...%%%.....................%%....%%%.........%%%%.........%%%....%%.....................%%%...%%.................................
m .......%....%%.......................%%...%%...........%%...........%%...%%.......................%%....%.................................
m ...%.%%%%....%....%.%.%%%%%....%%%%.%%....%%.....%%...%%%%...%%.....%%....%%.%%%%....%%%%%.%.%....%....%%%%.%.......%..%.%%....%%.%..%....
m .%%%%%%%....%%.....%%%%%%%....%%%%%%%%%....%%....%%%%%%%%%%%%%%....%%....%%%%%%%%%....%%%%%%%.....%%....%%%%%%%.....%%%%%%%%%%%%%%%%%%....
m %%%%.%%.%....%....%%%%%.%%%...%%%.%%%......%....%%%..%%%%%%..%%%....%......%%%.%%%...%%%.%%%%%....%....%.%%.%%%%...%.%%.%%.%..%.%%.%%.%...
m %%...........%....%%....%%%...............%%.....%%....%%....%%.....%%...............%%%....%%....%...........%%..........................
m .%%..........%.....%%...%%%................%....%%....%%%%....%%....%................%%%...%%.....%..........%%...........................
m .%%.........%%.....%%...%%%................%.....%%....%%....%%.....%................%%%...%%.....%%.........%%...........................
m %%%...%%....%%%....%%...%%%%....%....%.%%%%%%....%%....%%....%%....%%%%%%.%....%....%%%%...%%....%%%....%%...%%%.........%%....%%.........
m %%....%%%%%%%%.....%....%%%%%%%%%%%%%%%%%%%%%...%%.....%%.....%%...%%%%%%%%%%%%%%%%%%%%%....%.....%%%%%%%%....%%....%%...%%....%%...%%....
m .%.....%%%%%.%....%.....%..%%.%%%%.%%%.%.%%%%.........%%%%.........%%%%.%.%%%.%%%%.%%..%.....%....%.%%%%%.....%.....%.....%....%.....%....
m ......%%.......................%..........%%%..........%%..........%%%..........%.......................%%..........%%...%%....%%...%%....
m ......%%%......................%...........%...........%%...........%...........%......................%%%..........%....%%....%%....%....
m ......%%%.....................%%..........%%%.........%%%%.........%%%..........%%.....................%%%.........%%....%%....%%....%%...
m ..%%%%%%....%%.%.%%%....%%%....%....%.%...%%%%%%..%....%%....%..%%%%%%...%.%....%....%%%....%%%.%.%%....%%%%%%..%..%%%...%%....%%...%%%..%
m %%%%%%%%%....%%%%%%%....%%....%%....%%%....%%%%%%%%....%%....%%%%%%%%....%%%....%%....%%....%%%%%%%....%%%%%%%%%%%%%%%%%%%%....%%%%%%%%%%%
m .%..%%%%%........%%%.....%....%.%....%%....%..%%%%%....%%....%%%%%..%....%%....%.%....%.....%%%........%%%%%..%.%.%%%%%%%%%....%%%%%%%%%.%
m ......%%...........%%...%%%.........%%%...............%%%%...............%%%.........%%%...%%...........%%................%....%..........
m ......%%..........%%.....%..........%%................%%%%................%%..........%.....%%..........%%...............%%....%%.........
m ......%%..........%%%....%%.........%%................%%%%................%%.........%%....%%%..........%%................%....%..........
m %%....%%%.%........%.....%%.%%%%%.%%%%%...%......%...%%%%%%...%......%...%%%%%.%%%%%.%%.....%........%.%%%....%%.%...%...%%....%%...%...%.
m %%%...%%%%%%%%%...%%....%%%%%%%%%%%%%%%%%%%%%%%%%%%%%%%%%%%%%%%%%%%%%%%%%%%%%%%%%%%%%%%%....%%...%%%%%%%%%...%%%%%%%%.....%....%.....%%%%%
m %.....%%%..%%.....%%%....%%.%..%...%%%.%%%..%%.%%%%%.%%%%%%.%%%%%.%%..%%%.%%%...%..%.%%....%%%.....%%..%%%.....%.%.%.%...%%....%%...%.%.%.
m ......0%%..........%....%%%............................%%............................%%%....%..........%%1................%....%..........
m ......%%%..........%%...%%%............................%%............................%%%...%%..........%%%................%....%..........
m .......%...........%....%%............................%%%%............................%%....%...........%.................%....%..........
m %.%...%%.....%..%%%%%%..%%.......%%%.%...%.%.%.%.%.....%%.....%.%.%.%.%...%.%%%.......%%..%%%%%%..%.....%%...%.%...%.%....%....%....%.%...
m .%%...%%%...%%%%%%%%%%%%%%%....%%%%%%%%%%%%%%%%%%%.....%%.....%%%%%%%%%%%%%%%%%%%....%%%%%%%%%%%%%%%...%%%...%%....%%%....%....%....%%%...
m .%.....%......%..%%%%%%%%.....%%%%.%%%.%..%%%.%%%%............%%%%.%%%..%.%%%.%%%%.....%%%%%%%%..%......%.....%....%%%...%%....%%...%%%...
m %%%...%%%.........%%...........%..........%%%......................%%%..........%...........%%.........%%%...%%%....%%..............%%....
m .%%....%..........%%%.........%%%..........%%......................%%..........%%%.........%%%..........%....%%....%%%..............%%%...
m %%%....%%..........%...........%...........%%......................%%...........%...........%..........%%....%%%...%%................%%...
m .%%...%%%%%.......%%%...%%.%%.%%%....%....%%%...%%.%%.%..%.%%.%%...%%%....%....%%%.%%.%%...%%%.......%%%%%...%%....%%%%%..........%%%%%...
m %%....%%%%%%%%%....%%...%%%%%%%%....%%%%%%%%%....%%%%%%%%%%%%%%....%%%%%%%%%....%%%%%%%%...%%....%%%%%%%%%....%%....%%%%%%%....%%%%%%%....
m .%....%%..%%%%.....%....%%%%%.%%....%....%%.....%%%.%......%.%%%.....%%....%....%%.%%%%%....%.....%%%%..%%....%....%%%..%%%....%%%..%%%...
m .%%..........%...........%....%%................%%%..........%%%................%%....%...........%..........%%....%%%..............%%%...
m .%..........%%..........%%%....%................%%%..........%%%................%....%%%..........%%..........%....%%%..............%%%...
m .%%..........%%.........%%.....%................%%............%%................%.....%%.........%%..........%%....%%................%%...
m .%%..%%.....%%%%%.%..%..%%.....%%....%%%%.%%.%%.%%%..........%%%.%%.%%.%%%%....%%.....%%..%..%.%%%%%.....%%..%%....%%....%......%....%%...
m %%%%%%%%....%%%%%%%%%%%%%%%...%%....%%%%%%%%%%%%%%%....%%....%%%%%%%%%%%%%%%....%%...%%%%%%%%%%%%%%%....%%%%%%%%....%%...%%%%%%%%...%%....
m ...%..%%.....%%.%.%%%...1%%...%%.....%%%%.%.%.%%................%%.%.%.%%%%.....%%...%%0...%%%.%.%%.....%%..%......%%.....%%..%%.....%%...
m ......%%%..........%................%%%..................................%%%................%..........%%%..........%%...%%....%%...%%....
m ......%%..........%%%................%....................................%................%%%..........%%.........%%.....%....%.....%%...
m ......%%..........%%%................%%..................................%%................%%%..........%%..........%%....%....%....%%....
m .%...%%%%..%%......%%.......%.%.....%%%...%%..........%..%..........%%...%%%.....%.%.......%%......%%..%%%%...%....%%%....%....%....%%%...
m .%%%%%%%%%%%%%.....%.....%%%%%%%%%%%%%%....%%...%%%...%%%%...%%%...%%....%%%%%%%%%%%%%%.....%.....%%%%%%%%%%%%%.....%%....%....%....%%....
m .%%..%%..%%.%......%.....%..%%%%%%..%%.....%....%%%..........%%%....%.....%%..%%%%%%..%.....%......%.%%..%%..%%.....%................%....
m .%%...............%%..........%%%...%%.....%.....%%..........%%.....%.....%%...%%%..........%%...............%%....%%................%%...
m %%.................%..........%%%...%%%...%%....%%%..........%%%....%%...%%%...%%%..........%.................%%...%%................%%...
m %%%...............%%...........%%...%%%....%....%%%..........%%%....%....%%%...%%...........%%...............%%%....%%..............%%....
m .%%...%.%...%%...%%%%%%...%....%....%%%....%%....%%%........%%%....%%....%%%....%....%...%%%%%%...%%...%.%...%%....%%%%%..........%%%%%...
m %%%....%%%%%%%%%%%%%%%%%%%....%%%...%%%...%%.....%%%%%%%%%%%%%%.....%%...%%%...%%%....%%%%%%%%%%%%%%%%%%%....%%%....%%%%%%%....%%%%%%%....
m %%%....%.%%.%%...%.%.%.%%%.....%.....%%...%%%...%%...%%..%%...%%...%%%...%%.....%.....%%%.%.%.%...%%.%%.%....%%%.......%.%%....%%.%.......
m .%%............................%%...%%.....%%......................%%.....%%...%%............................%%...........%....%..........
m %%............................%%.....%....%%%......................%%%....%.....%%............................%%.........%%....%%.........
m %%.............................%....%%%....%%......................%%....%%%....%.............................%%..........%....%..........
m %%%..%%.%%%.%.%.%.%%.%%.%...%%%%.....%%....%%%%.%......%%......%.%%%%....%%.....%%%%...%.%%.%%.%.%.%.%%%.%%..%%%%%.......%%....%%.......%%
m %%%%%%%%%%%%%%%%%%%%%%%%%%%%%%%%%....%%...%%%%%%%%%....%%....%%%%%%%%%...%%....%%%%%%%%%%%%%%%%%%%%%%%%%%%%%%%%%%%%%%....%%....%%....%%%%%
m .%..%%%......%...%%%%%%%%%.....%%...%%......%%.%%%.....%%.....%%%.%%......%%...%%.....%%%%%%%%%...%......%%%..%.%.%%%%....%....%....%%%%.%
m ..................%%%...............%%...........%....%%%%....%...........%%...............%%%......................%.....%....%.....%....
m ..................%%%...............%%..........%%....%%%%....%%..........%%...............%%%.....................%%%...%%....%%...%%%...
m ...................%%...............%%%.........%%%....%%....%%%.........%%%...............%%.......................%....%%....%%....%....
m .%%%.........%.....%....%%%..%%%....%%%%%%%%%...%%%....%%....%%%...%%%%%%%%%....%%%..%%%....%.....%.........%%%....%%....%%....%%....%%...
m %%%%%%%%....%%....%%.....%%%%%%%%....%%%%%%%.....%%....%%....%%.....%%%%%%%....%%%%%%%%.....%%....%%....%%%%%%%%....%....%%....%%....%....
m %%%.%.%%%....%%...%%%...%%%%%.%%%....%.%%%%.....%%............%%.....%%%%.%....%%%.%%%%%...%%%...%%....%%%.%.%%%....%.....%....%.....%....
m ......%%.....%....%%..........%%%................%............%................%%%..........%%....%.....%%..........%.....%....%.....%....
m .......%%...%%....%%...........%........*..*....%%%..........%%%....*..*........%...........%%....%%...%%..........%%%....%....%....%%%...
m ......%%.....%....%%...........%%................%............%................%%...........%%....%.....%%..........%....%%....%%....%....
m %%%...%%%....%%.%%%%.....%%...%%%%%.%%%%...1.....%%..........%%.....0...%%%%.%%%%%...%%.....%%%%.%%....%%%...%%%.%%%%....%%....%%....%%%%.
m %%.....%1....%%%%%%%....%%%%%%%%%%%%%%%%%%%%....%%.....%%.....%%....%%%%%%%%%%%%%%%%%%%%....%%%%%%%....0%.....%%%%%%%%....%....%....%%%%%%
m ..%....%....%.%.%%%.....%%%%%...%....%%%..%%....%%%....%%....%%%....%%..%%%....%...%%%%%.....%%%.%.%....%....%..%%%..%....%....%....%..%%%
m ......%%%................%................%%.....%.....%%.....%.....%%................%................%%%................%....%..........
m ......%%.................%................%%%....%....%%%%....%....%%%................%.................%%................%....%..........
m .......%%...............%%%................%.....%.....%%.....%.....%................%%%...............%%................%%....%%.........
m ....%%%%%%%..%......%%%.%%....%..%%.%.%...%%....%%.....%%.....%%....%%...%.%.%%..%....%%.%%%......%..%%%%%%%....%%.%.%....%....%....%.%.%%
m %%%%%%%%%%%%%%%%%%%%%%%%%%.....%%%%%%%....%%%....%%....%%....%%....%%%....%%%%%%%.....%%%%%%%%%%%%%%%%%%%%%%%%%%%%%%%%...%%....%%...%%%%%%
m %%%..%%%%%..%%.....%%..........%%.%%%.....%%....%%.....%%.....%%....%%.....%%%.%%..........%%.....%%..%%%%%..%%%.%%%......%....%......%%%.
m %%%....%%.....................%%%.........%%%....%....%%%%....%....%%%.........%%%.....................%%....%%%.........%%....%%.........
m %%....%%.......................%%.........%%%...%%%....%%....%%%...%%%.........%%.......................%%....%%.........%%....%%.........
m .%%...%%%.....................%%...........%%....%%...%%%%...%%....%%...........%%.....................%%%...%%...........%....%..........
m %%%...%%....%%%%%..%%.%.%...%%%%%...%.%..%%%%..%%%.....%%.....%%%..%%%%..%.%...%%%%%...%.%.%%..%%%%%....%%...%%%...%.....%%....%%.....%...
m %%%....%%...%%%%%%%%%%%%%%%%%%%%....%%%%%%%%%%%%%%....%%%%....%%%%%%%%%%%%%%....%%%%%%%%%%%%%%%%%%%%...%%....%%%...%%%%%%%%....%%%%%%%%...
m .%.....%%...%%....%%.%..%%%.%%.%%...%%.%%..%%%..%%%....%%....%%%..%%%..%%.%%...%%.%%.%%%..%.%%....%%...%%.....%....%%%%..%%....%%..%%%%...
m .......%.................%......................%%%..........%%%......................%.................%...........%.....%....%.....%....
m .......%.................%.......................%%..........%%.......................%.................%...........%%....%....%....%%....
m .......%.................%%.....................%%%..........%%%.....................%%.................%..........%%%....%....%....%%%...
m %%.....%%%%..%%..%.%.....%%%%%...%%%%...%.......%%.....%%.....%%.......%...%%%%...%%%%%.....%.%..%%..%%%%.....%%%%.%%%....%....%....%%%.%%
m %%%...%%%%%%%%%%%%%%....%%%%%%%%%%%%%%%%%%%%.....%%...%%%%...%%.....%%%%%%%%%%%%%%%%%%%%....%%%%%%%%%%%%%%...%%%%%%%%.....%....%.....%%%%%
m %%....%%%%..%...%%%%%...%%%......%..%....%%%%....%%..........%%....%%%%....%..%......%%%...%%%%%...%..%%%%....%%%.%..%....%....%....%..%.%
m %%%................%%....%%................%.....%%..........%%.....%................%%....%%................%%%..........%....%..........
m .%%...............%%%....%%................%....%%%..........%%%....%................%%....%%%...............%%...........%....%..........
m %%.................%%...%%%................%%...%%%..........%%%...%%................%%%...%%.................%%.........%%....%%.........
m %%......%...%.%%%.%%%....%.....%%%..%%....%%%....%....%..%....%....%%%....%%..%%%.....%....%%%.%%%.%...%......%%..%%.%...%%....%%...%.%%..
m %%....%%%....%%%%%%%....%%....%%%%%%%%.....%%....%%....%%....%%....%%.....%%%%%%%%....%%....%%%%%%%....%%%....%%%%%%%%....%....%....%%%%%%
m .%.....%%...%%%..%%.....%%%....%%%%%%%.....%%....%%...%..%...%%....%%.....%%%%%%%....%%%.....%%..%%%...%%.....%..%%.%.....%....%.....%.%%.
m .......%.................%%..........%.....%%......................%%.....%..........%%.................%.................%....%..........
m .......%%................%%..........%%...%%%......................%%%...%%..........%%................%%.................%....%..........
m .......%................%%..........%%%....%%......................%%....%%%..........%%................%.................%....%..........
m ...%%.%%....%..%%..%%...%%%..%.%%....%.....%%%%..%....%..%....%..%%%%.....%....%%.%..%%%...%%..%%..%....%%.%%...%.%.%.%%.%%....%%.%%.%.%.%
m %%%%%%%%%...%%%%%%%%.....%%%%%%%....%%....%%%%%%%%%...%%%%...%%%%%%%%%....%%....%%%%%%%.....%%%%%%%%...%%%%%%%%%%%%%%%%%%%%....%%%%%%%%%%%
m %..%.%.%%....%%%%%%.%...%%%%%%%.%...%%%...%%%%%%%%%....%%....%%%%%%%%%...%%%...%.%%%%%%%...%.%%%%%%....%%.%.%..%%.%%%.%.%%......%%.%.%%%.%
m .............%%..........%%.........%%....%%%....%%....%%....%%....%%%....%%.........%%..........%%.......................................
m .............%%..........%%..........%%....%.....%....%%%%....%.....%....%%..........%%..........%%.......................................
m ............%%..........%%...........%.....%%...%%%....%%....%%%...%%.....%...........%%..........%%......................................
m .%%..%..%%%%%%%%.%%.%....%....%.%.%.%%.....%%...%%%....%%....%%%...%%.....%%.%.%.%....%....%.%%.%%%%%%%%..%..%%.%.%%.%...%......%...%.%%.%
m %%%%%%%%%%%%%%%%%%%%%....%.....%%%%%%%%....%.....%%....%%....%%.....%....%%%%%%%%.....%....%%%%%%%%%%%%%%%%%%%%%%%%%%%...%%%%%%%%...%%%%%%
m %%%..%.%.%%%.%%%%%%%.....%.....%%%...%%...%%%...%%.....%%.....%%...%%%...%%...%%%.....%.....%%%%%%%.%%%.%.%..%%%%%%%%%...%.%..%.%...%%%%%%
